
    NO ./pars/path_to_the_north_texture/colorstone.xpm
    F 133,125,10

SO ./pars/path_to_the_south_texture/redbrick.xpm
C 55,110,3
WE ./pars/path_to_the_west_texture/wood.xpm
EA ./pars/path_to_the_east_texture/bluestone.xpm

        1111111111111111111111111 1
        1000000001100000000000011101
        111111111111111111111111111
        10110000010101 1000000000001111             1111111
        1111111111111111111111111111              1110111001
        10100111100100000000000000001                1111001
111111111011000001100000000000001111             11111010001
100000000110000011110111110111111                     110001
11110111111111011100000010001            1              111
11110111111111011101010010001           101
11000000110101011100000010001           111
10000000000000001100000010001
10000000000000001101010010001           1111
11000001110101011111011110N0111         10011
1111011101110101010111101000101         11111
111111111111111111111111111111
