
       NO ./pars/path_to_the_north_texture/colorstone.xpm
    F 133,125,10
SO ./pars/path_to_the_south_texture/redbrick.xpm
C 55,110,3
WE ./pars/path_to_the_west_texture/wood.xpm
EA ./pars/path_to_the_east_texture/bluestone.xpm

        1111111111111111111111111
        1000000000110000000000001
        1011000001110000000000001
        1001000000000000000000001
111111111011000001100000000000001
10000000011000001110111110111111
11110111111111011100000010001
11110111111111011101010010001
11000000110101011100000010001
10000000000000001100000010001
10000000000000001101010010001
11000001110101011111011110N0111
11110111 1110101 10111101000101
11111111 1111111 1111111111111