
NO ./pars/path_to_the_north_texture/colorstone.xpm
SO ./pars/path_to_the_south_texture/redbrick.xpm
WE ./pars/path_to_the_west_texture/wood.xpm
EA ./pars/path_to_the_east_texture/bluestone.xpm

F 133,125,2
C 55,110,1

        1111111111111111111111111111
        10000000011000000000000111011
        111111111111111111111111111001          111  
        10110000010101110000000000011           101
        101111111111111111111111111111          111
        1010011110010000000000000001            
111111111011000001100000000000001111           
10000000011000001111011111011111 111111            
11110111111111011100000010001         
11110111111111011101010010001
110000001101010111E00000010001            
10000000000000001100000010001  1      
10000000000000001101010010001 101   
11000001110101011111011110011101              11111111
1111011101110101010111101000101              10000001
111111111111111111111111111111               11111111
1