
NO      ./pars/path_to_the_north_texture/colorstone.xpm
SO ./pars/path_to_the_south_texture/redbrick.xpm

C    55,110,1 
WE                                ./pars/path_to_the_west_texture/wood.xpm
EA                ./pars/path_to_the_east_texture/bluestone.xpm


F      133,125,1




111111111
1000000001                        1
1111111111111111111111111111111 1101
        10000000011000000000000111011
        111111111111111111111111111001          11111
        10110000010101110000000000011           100001
        101111111111111111111111111111           1111
        1010011110010000000000000001            
111111111011000001100000000000000111          
100000000110000011110111110111111111111              11111111     
11110111111111011100000010001                        10000011
1111011111111101110101001000111                      10000001
110000001101010110E0000001000101                     10000001
10000000000000001100000010001 11                     11111111
10000000000000001101010010001 101   
11000001110101011111011110011101              11111111
1111011101110101010111101000101              10000001
111111111111111111111111111111              11111111
11111111111100101
 11111111111111101                      
 1111111111111111
